academia economic papers: academia econ. pap.
academy of management journal: acad. manage. j.
academy of management review: acad. manage. rev.
accounting review: acc. rev.
accounting, business and financial history: acc., bus. finan. hist.
aces bulletin: aces bull.
acta oeconomica: acta oecon.
advances in consumer research: adv. consum. res.
advancing the consumer interest: advanc. cons. interest
african development review/revue africaine de developpement: african devel. rev./revue africaine devel.
african economic history: african econ. hist.
african finance journal: african finance j.
afrika spectrum: afrika spec.
agenda: agenda
agribusiness: agribusiness
agricultural and resource economics review: agr. resource econ. rev.
agricultural economics research: agr. econ. res.
agricultural economics: agr. econ.
agricultural finance review: agr. finance rev.
agriculture and human values: agr. human values
agriculture and resources quarterly: agr. resources quart.
agronomia mesoamericana: agronomia mesoamericana
allgemeines statistisches archiv/journal of the german statistical society: allgemeines statistisches arch./j. german statistical society
american economic review: am. econ. rev.
american economist: am. economist
american enterprise: am. enterprise
american historical review: am. historical rev.
american journal of agricultural economics: am. j. agr. econ.
american journal of economics and sociology: am. j. econ. sociology
american journal of political science: am. j. polit. sci.
american law and economics review: am. law econ. rev.
american political science review: am. polit. sci. rev.
american prospect: am. prospect
american psychologist: am. psychol
american real estate and urban economics association journal: am. real estate urban econ. assoc. j.
american statistician: am. statistician
analyse prévision: anal. prévision
annales d'economie et de statistique: ann. econ. statist.
annales de l'insee: ann. insee
annales de sciences economiques appliqués: ann. sci. econ. appl.
annali della facoltà di economia e commercio, università palermo: ann. fac. econ. com., univ. palermo
annals of economic and social measurement: ann. econ. soc. meas.
annals of economics and finance: ann. econ. finance
annals of public and cooperative economics: ann. public coop. econ.
annals of regional science: ann. reg. sci.
annals of the american academy of political and social science: ann. am. acad. polit. soc. sci.
antitrust bulletin: antitrust bull.
antitrust law and economics review: antitrust law econ.
applied economics letters: appl. econ. letters
applied economics: appl. econ.
applied financial economics: appl. finan. econ.
applied geography and development: appl. geogr. devel.
applied mathematical finance: appl. math. finance
aquaculture economics and management: aquaculture econ. manage.
archives of economic history: archives econ. hist.
arquivo do instituto gulbenkian de ciência: arquivo inst.
artha-vikas: artha-vikas
arthaniti: arthaniti
asean economic bulletin: asean econ. bull.
asia pacific business review: asia pacific bus. rev.
asia pacific journal of economics and business: asia pacific j. econ. bus.
asia-pacific development journal: asia-pacific devel. j.
asia-pacific economic review: asia-pacific econ. rev.
asia-pacific financial markets: asia-pacific finan. markets
asian development review: asian devel. rev.
asian economic journal: asian econ. j.
asian economic review: asian econ. rev.
asian journal of agricultural economics: asian j. agr. econ.
asian-pacific economic literature: asian-pacific econ. lit.
atlantic economic journal: atlantic econ. j.
aussenwirtschaft: aussenwirtschaft
australasian journal of regional studies: australasian j. reg. stud.
australian bulletin of labour: australian bull. lab.
australian commodities forecasts and issues: australian commodities forecasts issues
australian economic history review: australian econ. hist. rev.
australian economic papers: australian econ. pap.
australian economic review: australian econ. rev.
australian journal of agricultural and resource economics: australian j. agr. resource econ.
australian journal of agricultural economics: australian j. agr. econ.
australian journal of labour economics: australian j. lab. econ.
australian journal of management: australian j. manage.
australian tax forum: australian tax forum
banca nazionale del lavoro quarterly review: banca naz. lavoro quart. rev.
bancaria: bancaria
banco de españa economic bulletin: banco españa econ. bull.
bangladesh development studies: bangladesh devel. stud.
bangladesh economic review: bangladesh econ. rev.
bank of england quarterly bulletin: bank engl. quart. bull.
bank of israel banking review: bank israel banking rev.
bank of israel economic review: bank israel econ. rev.
bank of japan monetary and economic studies: bank japan monet. econ. stud.
bank of korea economic papers: bank korea econ. pap.
bank of valletta review: bank valletta rev.
banker: banker
behavioral research in accounting: behavioral res. acc.
bell journal of economics: bell j. econ.
biometrika: biometrika
boletin del musea social argentino: bol. mus. soc. argent.
book: book
brazilian electronic journal of economics: brazilian electronic j. econ.
brazilian review of econometrics: brazilian rev. econometrics
british journal of industrial relations: brit. j. ind. relat.
british review of economic issues: brit. rev. econ. issues
brookings papers on economic activity: brookings pap. econ. act.
brookings-wharton papers on financial services: brookings-wharton pap. finan. services
brookings-wharton papers on urban affairs: brookings-wharton pap. urban aff.
buffalo law review: buffalo law rev.
bulletin for international fiscal documentation: bull. int. fiscal doc.
bulletin of economic research: bull. econ. res.
bulletin of indonesian economic studies: bull. indonesian econ. stud.
bulletin of the oxford university institute of economics and statistics: bull. oxford univ. inst. econ. statist.
bulletin of university of osaka prefecture: bull. univ. osaka prefect.
business and economic history: bus. econ. hist.
business economics: bus. econ.
business history review: bus. hist. rev.
business history: bus. hist.
cahiers d'economie et sociologie rurales: cah. econ. sociologie rurales
cahiers d'economie politique: cah. econ. politique
cahiers economiques de bruxelles: cah. econ. bruxelles
cahiers economiques et sociaux: cah. econ. soc.
california management review: calif. manage. rev.
cambridge economic policy review: cambridge econ. pol. rev.
cambridge journal of economics: cambridge j. econ.
canadian business economics: can. bus. econ.
canadian journal of agricultural economics: can. j. agr. econ.
canadian journal of development studies: can. j. devel. stud.
canadian journal of economics: can. j. econ.
canadian journal of regional science: can. j. reg. sci.
canadian public policy: can. public pol.
canadian tax journal: can. tax j.
carnegie-rochester conference series on public policy: carnegie-rochester conf. ser. public pol.
cato journal: cato j.
cemla boletin mensual: cemla bol. mens.
central european journal for operations research and economics: central europ. j. operations res. econ.
central european journal of operations research: central europ. j. operations res.
cepal review: cepal rev.
challenge: challenge
china economic review: china econ. rev.
china quarterly: china quart.
chinese economic studies: chinese econ. stud.
chinese economy: chinese economy
ciriec-españa, revista de economía pública, social y cooperativa: ciriec-españa, revista econ. pública, soc. cooperativa
cityscape: a journal of policy development and research: cityscape: j. pol. devel. res.
colección estudios cieplan: colección estud. cieplan
columbia journal of world business: columbia j. world bus.
comercio exterior: comercio exterior
comertul modern: comertul mod.
communications and strategies: communications strategies
communist economies and economic transformation: communist economies econ. transformation
comparative economic studies: compar. econ. stud.
computational economics: computational econ.
computer science in economics and management: computer sci. econ. manage.
computing in science and engineering: comput sci. eng.
conflict management and peace science: conflict manage. peace sci.
consommation: consommation
constitutional political economy: constit. polit. economy
contemporary economic policy: contemporary econ. pol.
contemporary policy issues: contemp. pol. issues
contributions to political economy: contrib. to polit. economy
critical review: critic. rev.
cuadernos de economia: cuadernos econ.
cuadernos de la c.v.f.: cuadernos de la c.v.f.
cuadernos economicos de i.c.e.: cuadernos econ. i.c.e.
cyprus journal of economics: cyprus j. econ.
cyprus review: cyprus rev.
czechoslovak economic digest: czech. econ. digest.
czechoslovak economic papers: czech. econ. pap.
czechoslovak journal for operations research: czech. j. operations res.
de economist: de economist
de economía: de economía
defence and peace economics: defence peace econ.
defence economics: defence econ.
demografía y economía: demogr. econ.
demography: demography
der donaurum: der donaurum
desarrollo económico: desarrollo econ.
developing economies: developing economies
development and change: devel. change
development southern africa: devel. southern africa
development: development
east african journal of rural development: east african j. rural devel.
east-west journal of economics and business: east-west j. econ. bus.
east-west series in economics, business, and the environment: east-west ser. econ., bus., environ.
eastern africa economic review: eastern africa econ. rev.
eastern economic journal: eastern econ. j.
eastern european economics: eastern europ. econ.
ecological economics: ecolog. econ.
econometric reviews: econometric rev.
econometric theory: econometric theory
econometrica: econometrica
econometrics journal: econometrics j.
economia (pontifical catholic university of peru): economia (peru)
economia (portuguese catholic university): economia (portugal)
economia aplicada/brazilian journal of applied economics: econ. aplicada/brazilian j. appl. econ.
economia delle scelte pubbliche/journal of public finance and public choice: econ. scelte pubbliche/j. public finance public choice
economia e lavoro: econ. lavoro
economia industrial: econ. ind.
economia internazionale/international economics: econ. int./int. econ.
economia internazionale: econ. int.
economia mexicana, nueva epoca: econ. mexicana, nueva epoca
economia politica: econ. politica
economic affairs: econ. aff.
economic analysis and policy, new series: econ. anal. pol., n.s.
economic analysis and policy: econ. anal. pol.
economic analysis and workers' management: econ. anal. workers' manage.
economic analysis: econ. anal.
economic and business bulletin: econ. bus. bull.
economic and business review: econ. bus. rev.
economic and financial modelling: econ. finan. modelling
economic and financial review: econ. finan. rev.
economic and industrial democracy: econ. ind. democracy
economic and labour relations review: econ. lab. relat. rev.
economic and social review: econ. soc. rev.
economic bulletin of ghana, second series: econ. bull. ghana, 2nd ser.
economic computation and economic cybernetics studies and research: econ. computat. econ. cybern. stud. res.
economic design: econ. design
economic development and cultural change: econ. devel. cult. change
economic development quarterly: econ. devel. quart.
economic forum: econ. forum
economic geography: econ. geogr.
economic history review, second series: econ. hist. rev., 2nd ser.
economic history review: econ. hist. rev.
economic inquiry: econ. inquiry
economic issues: econ. issues
economic journal: econ. j.
economic modelling: econ. modelling
economic notes: econ. notes
economic perspectives: econ. perspect.
economic policy review: econ. pol. rev.
economic policy: a european forum: econ. pol.: a europ. forum
economic record: econ. rec.
economic review (keizai kenkyu): econ. rev. (keizai kenkyu)
economic studies quarterly: econ. stud. quart.
economic systems research: econ. systems res.
economic systems: econ. systems
economic theory: econ. theory
economica, n.s.: economica, n.s.
economica: economica
economics and business education: econ. bus. educ.
economics and philosophy: econ. philos.
economics and politics: econ. politics
economics letters: econ. letters
economics of education review: econ. educ. rev.
economics of governance: econ. governance
economics of innovation and new technology: econ. innovation new tech.
economics of planning: econ. planning
economics of transition: econ. transition
economics: a biannual collection of recent german studies: econ.: biann. collec. recent ger. stud.
economics: economics
economics: the journal of the economics association: econ.: j. econ. assoc.
economie appliquée: econ. appl.
economie et prévision: econ. prévision
economie internationale: econ. int.
economie rurale: econ. rurale
economies et sociétés: econ. soc.
economisch en sociaal tijdschrift: econ. soc. tijdschr.
economy and history: economy hist.
economy and society: economy society
economía chilena: econ. chilena
económica (national university of la plata): económica (la plata)
education economics: educ. econ.
eib papers: eib pap.
ekonomia: ekonomia
ekonomicko-matematicky obzor: ekon.-mat. obzor
ekonomika radvanskoyi ukhayeny: ekonomika radvanskoyi ukhayeny
ekonomiska samfundets tidskrift: ekon. samfundets tidskr.
ekonomska istrazivanja/economic research: ekon. istrazivanja/econ. res.
ekonomska misao i praksa: ekon. misao praksa
el trimestre economico: trim. econ.
empirica: empirica
empirical economics: empirical econ.
energy economics: energy econ.
energy journal: energy j.
energy studies review: energy stud. rev.
engineering economist: eng. econ.
enterprise and society: enterprise society
entrepreneurship and regional development: entrepreneurship reg. devel.
environment and development economics: environ. devel. econ.
environment and planning a: environ. planning a
environment and planning c: government and policy: environ. planning c: govt. pol.
environmental and resource economics: environ. resource econ.
environmental economics and policy studies: environ. econ. pol. stud.
environmental values: environ. values
estudios de economia: estud. de econ.
estudios económicos: estud. econ.
estudios empresariales: estud. empresariales
estudios internacionales: estud. int.
estudos economicos: estudos econ.
etudes et conjoncture: etud. conjoncture
eurasian geography and economics: eurasian geogr. econ.
eurochoices: eurochoices
european economic review: europ. econ. rev.
european finance review: europ. finance rev.
european financial management: europ. finan. manage.
european journal of development research: europ. j. devel. res.
european journal of finance: europ. j. finance
european journal of housing policy: europ. j. housing pol.
european journal of industrial relations: europ. j. ind. relat.
european journal of international relations: europ. j. int. relat.
european journal of law and economics: europ. j. law econ.
european journal of political economy: europ. j. polit. economy
european journal of the history of economic thought: europ. j. hist. econ. thought
european review of agricultural economics: europ. rev. agr. econ.
european review of economic history: europ. rev. econ. hist.
experimental economics: exper. econ.
explorations in economic history: explorations econ. hist.
family economics and nutrition review: family econ. nutrition rev.
family economics review: family econ. rev.
fdic banking review: fdic banking rev.
federal reserve bank business review of philadelphia: fed. reserve bank bus. rev. phila.
federal reserve bank of atlanta economic review: fed. reserve bank atlanta econ. rev.
federal reserve bank of atlanta monthly review: fed. reserve bank atlanta rev.
federal reserve bank of boston new england economic review: fed. reserve bank boston new eng. econ. rev.
federal reserve bank of chicago economic perspectives: fed. reserve bank chicago econ. perspect.
federal reserve bank of cleveland economic review: fed. reserve bank cleveland econ. rev.
federal reserve bank of dallas economic and financial review: fed. reserve bank dallas econ. finan. rev.
federal reserve bank of dallas economic review: fed. reserve bank dallas econ. rev.
federal reserve bank of kansas city economic review: fed. reserve bank kansas city econ. rev.
federal reserve bank of kansas city monthly review: fed. reserve bank kansas city rev.
federal reserve bank of minneapolis quarterly review: fed. reserve bank minneapolis quart. rev.
federal reserve bank of new york economic policy review: fed. reserve bank new york econ. pol. rev.
federal reserve bank of new york monthly review: fed. reserve bank new york rev.
federal reserve bank of new york quarterly review: fed. reserve bank new york quart. rev.
federal reserve bank of philadelphia business review: fed. reserve bank philadelphia bus. rev.
federal reserve bank of richmond economic quarterly: fed. reserve bank richmond econ. quart.
federal reserve bank of richmond economic review: fed. reserve bank richmond econ. rev.
federal reserve bank of san francisco economic review: fed. reserve bank san francisco econ. rev.
federal reserve bank of san francisco monthly review: fed. reserve bank san francisco rev.
federal reserve bank of st. louis review: fed. reserve bank st. louis rev.
federal reserve bulletin: fed. reserve bull.
feminist economics: feminist econ.
finance a Úver: finance Úver
finance and development: finance devel.
finance and stochastics: finance stochastics
finance and trade review: finance trade rev.
finance india: finance india
finance: finance
financial engineering and the japanese markets: finan. eng. japanese markets
financial history review: finan. hist. rev.
financial industry studies: finan. industry stud.
financial management: finan. manage.
financial markets, institutions and instruments: finan. markets, inst. instruments
financial practice and education: finan. practice educ.
financial review: finan. rev.
finanzarchiv: finanzarch.
finnish economic papers: finnish econ. pap.
fiscal studies: fisc. stud.
food policy: food pol.
food research institute studies: food res. inst. stud.
foreign affairs: foreign aff.
foresight: foresight
forum for development studies: forum devel. stud.
forum for social economics: forum soc. econ.
games and economic behavior: games econ. behav.
geneva papers on risk and insurance theory: geneva pap. risk ins. theory
geneva papers on risk and insurance: issues and practice: geneva pap. risk ins.: issues practice
german economic review: ger. econ. rev.
giornale degli economisti e annali di economia: giorn. econ.
global business and economics review: global bus. econ. rev.
global economic review: global econ. rev.
global economy quarterly: global economy quart.
global environmental politics: global environ. politics
global finance journal: global finance j.
gospodarstvo istre: gospodarstvo istre
greek economic review: greek econ. rev.
growth and change: growth change
harvard business review: harvard bus. rev.
health care management science: health care manage. sci.
health economics: health econ.
health marketing quarterly: health market. quart.
health services research: health services res.
historical abstracts: hist. abstr.
history of economic ideas: hist. econ. ideas
history of economics review: hist. econ. rev.
history of political economy: hist. polit. economy
hitotsubashi journal of commerce and management: hitotsubashi j. com. manage.
hitotsubashi journal of economics: hitotsubashi j. econ.
hong kong economic papers: hong kong econ. pap.
housing finance review: housing finance rev.
housing policy debate: housing pol. debate
housing studies: housing stud.
human resource development quarterly: human resource devel. quart.
humanomics: humanomics
ifo studien: ifo studien
iium journal of economics and management: iium j. econ. manage.
il pensiero economico italiano: il pensiero econ. italiano
il politico: il politico
il risparmio: il risparmio
illinois agricultural economics: ill. agr. econ.
imf staff papers: imf staff pap.
impact of science on society: impact sci. society
independent review: independent rev.
indian economic and social history review: indian econ. soc. hist. rev.
indian economic journal: indian econ. j.
indian economic review: indian econ. rev.
indian journal of applied economics: indian j. appl. econ.
indian journal of economics: indian j. econ.
indian journal of gender studies: indian j. gender stud.
indian journal of labour economics: indian j. lab. econ.
indian journal of quantitative economics: indian j. quant. econ.
indiana business review: indiana bus. rev.
industrial and corporate change: ind. corp. change
industrial and labor relations review: ind. lab. relat. rev.
industrial organization review: ind. organ. rev.
industrial relations: ind. relat.
industry and development: industry devel.
industry and innovation: industry innovation
info: info
informacion comercial española revista de economia: info. comercial española revista econ.
information economics and policy: info. econ. pol.
innovations: innovations
inquiry: inquiry
insurance: mathematics and economics: ins.: mathematics econ.
integration and trade: integration trade
intermountain economic review: intermountain econ. rev.
international advances in economic research: int. advances econ. res.
international contributions to labour studies: int. contrib. to lab. stud.
international economic insights: int. econ. insights
international economic journal: int. econ. j.
international economic review: int. econ. rev.
international economy: int. economy
international finance: int. finance
international game theory review: int. game theory rev.
international journal of applied economics and econometrics: int. j. appl. econ. econometrics
international journal of business: int. j. bus.
international journal of finance and economics: int. j. finance econ.
international journal of forecasting: int. j. forecasting
international journal of game theory: int. j. game theory
international journal of industrial organization: int. j. ind. organ.
international journal of manpower: int. j. manpower
international journal of maritime economics: int. j. maritime econ.
international journal of production economics: int. j. product. econ.
international journal of research in marketing: int. j. res. market.
international journal of social economics: int. j. soc. econ.
international journal of the economics of business: int. j. econ. bus.
international journal of theoretical and applied finance: int. j. theoretical appl. finance
international journal of transport economics: int. j. transport econ.
international journal of urban and regional research: int. j. urban reg. res.
international labour review: int. lab. rev.
international monetary fund staff papers: int. monet. fund staff pap.
international organization: int. organ.
international policy review: int. pol. rev.
international regional science review: int. reg. sci. rev.
international review of applied economics: int. rev. appl. econ.
international review of economics and finance: int. rev. econ. finance
international review of financial analysis: int. rev. finan. anal.
international review of law and economics: int. rev. law econ.
international social science journal: int. soc. sci. j.
international tax and public finance: int. tax public finance
international trade journal: int. trade j.
investigaciones economicas: investigaciones econ.
investigación económica: investigación econ.
investment policy: invest. pol.
irish banking review: irish banking rev.
irish journal of agricultural economics and rural sociology: irish j. agr. econ. rural sociology
ise review: ise rev.
islamic economic studies: islamic econ. stud.
jahrbuch der wirtschaft osteuropas: jahr. wirtsch. osteuropas
jahrbuch für regionalwissenschaft/review of regional research: jahr. regionalwissen./rev. reg. res.
jahrbücher für nationalökonomie und statistik: jahr. nationalökon. statist.
japan and the world economy: japan world economy
japan research quarterly: japan res. quart.
japanese economic review: japanese econ. rev.
japanese economic studies: japanese econ. stud.
japanese economy: japanese economy
journal for studies in economics and econometrics: j. stud. econ. econometrics
journal of accounting and economics: j. acc. econ.
journal of accounting research: j. acc. res.
journal of accounting, auditing and finance: j. acc., aud. finance
journal of african business: j. african bus.
journal of african economies: j. african economies
journal of african finance and economic development: j. african finance econ. devel.
journal of agricultural and applied economics: j. agr. appl. econ.
journal of agricultural and resource economics: j. agr. resource econ.
journal of agricultural economics research: j. agr. econ. res.
journal of agricultural economics: j. agr. econ.
journal of applied business research: j. appl. bus. res.
journal of applied econometrics: j. appl. econometrics
journal of applied economics: j. appl. econ.
journal of applied statistics: j. appl. statist.
journal of applied psychology: j. appl. psychol.
journal of asia-pacific business: j. asia-pacific bus.
journal of asian economics: j. asian econ.
journal of asian studies: j. asian stud.
journal of australian political economy: j. australian polit. economy
journal of bank research: j. bank res.
journal of banking and finance: j. banking finance
journal of behavioral economics: j. behavioral econ.
journal of bioeconomics: j. bioecon.
journal of business & economic statistics: j. bus. econ. statist.
journal of business and economic statistics: j. bus. econ. statist.
journal of business research: j. bus. res.
journal of business: j. bus.
journal of common market studies: j. common market stud.
journal of comparative economics: j. compar. econ.
journal of conflict resolution: j. conflict resolution
journal of consumer affairs: j. cons. aff.
journal of consumer policy: j. cons. pol.
journal of consumer psychology: j consum psychol
journal of consumer research: j. cons. res.
journal of corporate finance: contracting, governance and organization: j. corp. finan.: contracting, governance organ.
journal of cultural economics: j. cult. econ.
journal of derivatives: j. derivatives
journal of developing areas: j. developing areas
journal of development and economic policies: j. devel. econ. pol.
journal of development economics: j. devel. econ.
journal of development studies: j. devel. stud.
journal of east and west studies: j. east west stud.
journal of east-west business: j. east-west bus.
journal of econometrics: j. econometrics
journal of economic and social measurement: j. econ. soc. meas.
journal of economic and social policy: j. econ. soc. pol.
journal of economic and social research: j. econ. soc. res.
journal of economic behavior and organization: j. econ. behav. organ.
journal of economic cooperation among islamic countries: j. econ. cooperation islamic countries
journal of economic development: j. econ. devel.
journal of economic dynamics and control: j. econ. dynam. control
journal of economic education: j. econ. educ.
journal of economic growth: j. econ. growth
journal of economic history: j. econ. hist.
journal of economic integration: j. econ. integration
journal of economic issues: j. econ. issues
journal of economic literature: j. econ. lit.
journal of economic methodology: j. econ. methodology
journal of economic perspectives: j. econ. perspect.
journal of economic psychology: j. econ. psych.
journal of economic research: j. econ. res.
journal of economic studies: j. econ. stud.
journal of economic surveys: j. econ. surveys
journal of economic theory and econometrics: j. econ. theory econometrics
journal of economic theory: j. econ. theory
journal of economics & management strategy: j. econ. manage. strategy
journal of economics (mvea): j. econ. (mvea)
journal of economics (zeitschrift für nationalökonomie): j. econ. (z. nationalökon.)
journal of economics and business: j. econ. bus.
journal of economics and finance: j. econ. finance
journal of economics and management strategy: j. econ. manage. strategy
journal of education finance: j. educ. finance
journal of emerging markets: j. emerging markets
journal of empirical finance: j. empirical finance
journal of energy and development: j. energy devel.
journal of energy finance and development: j. energy finance devel.
journal of energy literature: j. energy lit.
journal of environment and development: j. environ. devel.
journal of environmental economics and management: j. environ. econ. manage.
journal of environmental planning and management: j. environ. planning manage.
journal of european economic history: j. europ. econ. hist.
journal of evolutionary economics: j. evolutionary econ.
journal of family and economic issues: j. family econ. issues
journal of far eastern business: j. far eastern bus.
journal of farm economics: j. farm econ.
journal of finance: j. finance
journal of financial and quantitative analysis: j. finan. quant. anal.
journal of financial economics: j. finan. econ.
journal of financial intermediation: j. finan. intermediation
journal of financial management and analysis: j. finan. manage. anal.
journal of financial research: j. finan. res.
journal of financial services research: j. finan. services res.
journal of forensic economics: j. forensic econ.
journal of futures markets: j. futures markets
journal of geographical systems: j. geograph. systems
journal of health economics: j. health econ.
journal of health politics, policy and law: j. health politics, pol. law
journal of higher education policy and management: j. higher educ. pol. manage.
journal of housing economics: j. housing econ.
journal of housing research: j. housing res.
journal of human resources: j. human res.
journal of income distribution: j. income distribution
journal of industrial economics: j. ind. econ.
journal of industry studies: j. industry stud.
journal of institutional and theoretical economics: j. inst. theoretical econ.
journal of interamerican studies and world affairs: j. interam. stud. world aff.
journal of interdisciplinary economics: j. interdisciplinary econ.
journal of international and comparative economics: j. int. compar. econ.
journal of international business studies: j. int. bus. stud.
journal of international development: j. int. devel.
journal of international economic law: j. int. econ. law
journal of international economics: j. int. econ.
journal of international financial markets, institutions and money: j. int. finan. markets, inst. money
journal of international money and finance: j. int. money finance
journal of international trade and economic development: j. int. trade econ. devel.
journal of king abdulaziz university: islamic economics: j. king abdulaziz univ.: islamic econ.
journal of labor economics: j. lab. econ.
journal of labor research: j. lab. res.
journal of law and economics: j. law econ.
journal of law, economics, and organization: j. law econ. organ.
journal of legal economics: j. legal econ.
journal of legal studies: j. legal stud.
journal of macroeconomics: j. macroecon.
journal of management accounting research: j. manage. acc. res.
journal of management and governance: j. manage. governance
journal of management: j. manage.
journal of marketing research: j. market. res.
journal of marketing: j. market.
journal of markets and morality: j. markets morality
journal of mathematical economics: j. math. econ.
journal of monetary economics: j. monet. econ.
journal of money, credit, and banking: j. money. credit. banking
journal of multinational financial management: j. multinat. finan. manage.
journal of peace research: j. peace res.
journal of peace science: j. peace sci.
journal of personality and social psychology: j. pers. soc. psychol.
journal of policy analysis and management: j. pol. anal. manage.
journal of policy modeling: j. pol. modeling
journal of policy reform: j. pol. reform
journal of political economy: j. polit. economy
journal of population economics: j. population econ.
journal of portfolio management: j. portfol. manage.
journal of post keynesian economics: j. post keynesian econ.
journal of private enterprise: j. private enterprise
journal of productivity analysis: j. productiv. anal.
journal of public and international affairs: j. public int. aff.
journal of public economic theory: j. public econ. theory
journal of public economics: j. public econ.
journal of public finance and public choice/economia delle scelte pubbliche: j. public finance public choice/econ. scelte pubbliche
journal of quantitative economics: j. quant. econ.
journal of real estate finance and economics: j. real estate finance econ.
journal of real estate literature: j. real estate lit.
journal of real estate portfolio management: j. real estate portfol. manage.
journal of real estate practice and education: j. real estate practice educ.
journal of real estate research: j. real estate res.
journal of regional analysis and policy: j. reg. anal. pol.
journal of regional science: j. reg. sci.
journal of regulatory economics: j. regul. econ.
journal of research in islamic economics: j. res. islamic econ.
journal of research in pharmaceutical economics: j. res. pharmaceut. econ.
journal of retailing: j. retailing
journal of risk research: j. risk res.
journal of risk and insurance: j. risk ins.
journal of risk and uncertainty: j. risk uncertainty
journal of social and economic development: j. soc. econ. devel.
journal of socio-economics: j. socio-econ.
journal of sports economics: j. sports econ.
journal of taxation: j. taxation
journal of technology transfer: j. tech. transfer
journal of the american real estate and urban economics association: j. am. real estate urban econ. assoc.
journal of the american statistical association: j. am. statistical assoc.
journal of the asia pacific economy: j. asia pacific economy
journal of the economics of business: j. econ. of bus.
journal of the history of economic thought: j. hist. econ. thought
journal of the japanese and international economies: j. japanese int. economies
journal of the royal statistical society, series a: j. roy. statistical society
journal of the social sciences: j. soc. sci.
journal of the statistical and social inquiry society of ireland: j. statistical soc. inquiry society ireland
journal of transnational management development: j. transnat. manage. devel.
journal of transport economics and policy: j. transp. econ. pol.
journal of urban economics: j. urban econ.
journal of world business: j. world bus.
journal of world trade law: j. world trade law
journal of world trade: j. world trade
kansantaloudellinen aikakauskirja: kansant. aikak.
keio economic studies: keio econ. stud.
kobe economic and business review: kobe econ. bus. rev.
kobe university economic review: kobe univ. econ. rev.
kokumin-keizai zasshi: kokumin-keizai zasshi
konjunkturpolitik: konjunkturpolitik
kredit und kapital: kredit kapital
kyklos: kyklos
kyoto university economic review: kyoto univ. econ. rev.
l'actualité economique/revue d'analyse economique: l'actual. econ./rev. anal. econ.
l'actualité economique: l'actual. econ.
l'impresa: l'impresa
l'industria, nuova serie: l'industria, n.s.
l'industria: l'industria
labor history: lab. hist.
labour economics: lab. econ.
labour: labour
lahore journal of economics: lahore j. econ.
land economics: land econ.
latin american politics and society: latin am. politics society
law and contemporary problems: law contemp. prob.
lecturas de economia: lecturas econ.
libyan economic and business review: libyan econ. bus. rev.
liiketaloudellinen aikakauskirja: liiketaloudellinen aikak.
lloyds bank review: lloyds bank rev.
local economy: local economy
logistics and transportation review: logist. transp. rev.
macroeconomic dynamics: macroecon. dynam.
malayan economic review: malayan econ. rev.
management accounting: manage. acc.
management science: manage. sci.
management training review: manage. train. rev.
management: management
managerial and decision economics: managerial dec. econ.
manchester school of economic and social studies: manchester sch. econ. soc. stud.
manchester school: manchester sch.
margin: margin
marine resource economics: marine resource econ.
maritime policy and management: maritime pol. manage.
marketing letters: market. letters.
marketing science: market. sci.
marquette business review: marquette bus. rev.
matekon: matekon
mathematical finance: math. finance
mathematical methods of operations research: math. methods operations res.
mathematical social sciences: math. soc. sci.
methodus: methodus
metrika: metrika
metroeconomica: metroecon.
michigan academician: mich. academician
michigan law review: mich. law rev.
middle east business and economic review: middle east bus. econ. rev.
middle east economic papers: middle east econ. pap.
middle east journal: middle east j.
middle east technical university studies in development: metu stud. devel.
mississippi valley journal of business and economics: miss. val. j. bus. econ.
mitteilungen aus der arbeitsmarkt- und berufsforschung: mitteilungen arbeitsmarkt- berufsforschung
moct-most: economic policy in transitional economies: moct-most: econ. pol. transitional economies
modern asian studies: mod. asian stud.
momento económico: momento econ.
mondo aperto: mondo aperto
moneda y crédito: moneda crédito
moneta e credito: moneta credito
monetary and economic studies: monet. econ. stud.
monthly labor review: mon. lab. rev.
multinational finance journal: multinat. finance j.
national institute economic review: nat. inst. econ. rev.
national tax journal: nat. tax j.
national westminster bank quarterly review: nat. westminster bank quart. rev.
nationaløkonomisk tidsskrift: nationaløkon. tidsskr.
natural resource modeling: natural res. modeling
natural resources journal: natural res. j.
nature: nature
nber working paper: nber-working-paper
nebraska journal of economics and business: nebr. j. econ. bus.
netnomics: netnomics
new economy: new economy
new england economic review: new england econ. rev.
new mexico business: new mexico bus.
new political economy: new polit. economy
new trends czech. econ.: new trends czech. econ.
new zealand economic papers: new zealand econ. pap.
new zealand geographer: new zealand geographer
nigerian journal of economic and social studies: nigerian j. econ. soc. stud.
nomura research institute quarterly economic review: nomura res. inst. quart. econ. rev.
nonlinear dynamics, psychology, and life sciences: nonlinear dynam., psych., and life sci.
nonprofit management and leadership: nonprofit manage. leadership
nordic journal of political economy: nordic j. polit. economy
north american actuarial journal: n. am. actuarial j.
north american journal of economics and finance: n. am. j. econ. finance
oecd economic studies: oecd econ. stud.
ohio state university bulletin of business research: ohio state u. bull. bus. res.
okonomi og politik: okon. polit.
okonomi: okonomi
opec review: opec rev.
open economies review: open economies rev.
or spectrum: or spectrum
or spektrum: or spektrum
orbis economicus: orbis econ.
oregon business review: oregon bus. rev.
organization and environment: organ. environ.
organization science: organ. sci.
osaka economic papers: osaka econ. pap.
oxford bulletin of economics and statistics: oxford bull. econ. statist.
oxford development studies: oxford devel. stud.
oxford economic papers: oxford econ. pap.
oxford review of economic policy: oxford rev. econ. pol.
pacific and asian journal of energy: pacific asian j. energy
pacific economic bulletin: pacific econ. bull.
pacific economic review: pacific econ. rev.
pacific-basin finance journal: pacific-basin finance j.
pakistan development review: pakistan devel. rev.
pakistan economic and social review: pakistan econ. soc. rev.
pakistan journal of applied economics: pakistan j. appl. econ.
papeles de economía española: pap. econ. española
papers in regional science: pap. reg. sci.
papers on non-market decision making: pap. non-market dec. making
peace research society international papers: peace res. society int. pap.
peace science society (international) papers: peace sci. society
pensamiento iberoamericano: revista de economía política: pensa. iberam.: revista econ. política
perspectives on labour and income: perspect. lab. income
pesquisa e planejamento econômico: pesquisa planejamento econ.
pharmacoeconomics: pharmacoecon.
philippine economic journal: philippine econ. j.
philippine journal of business and economics: philippine j. bus. econ.
philippine journal of business and finance: philippine j. bus. finance
philippine review of economics and business: philippine rev. econ. bus.
philippine review of economics: philippine rev. econ.
policy analysis: pol. anal.
policy review: pol. rev.
policy sciences: pol. sci.
policy studies: pol. stud.
policy: policy
politica economica: politica econ.
political science quarterly: polit. sci. quart.
politická ekonomie: politická ekon.
population and development review: population devel. rev.
population bulletin: population bull.
population research and policy review: population res. pol. rev.
population review: population rev.
population studies: population stud.
population: population
post-communist economies: post-communist economies
post-soviet affairs: post-soviet aff.
post-soviet geography and economics: post-soviet geogr. econ.
prague economic papers: prague econ. pap.
problemas del desarrollo: prob. desarrollo
problems of economic transition: prob. econ. transition
problems of economics: prob. econ.
psychological bulletin: psychol. bull.
public administration review: public admin. rev.
public budgeting and finance: public budg. finance
public choice: public choice
public finance quarterly: public finance quart.
public finance review: public finance rev.
public finance: public finance
public management sources: public management sources
public policy: public pol.
punjab university economist: punjab univ. econ.
quaderni di economia e finanza: quaderni econ. finanza
quaderni storici delle marche: quaderni storici delle marche
quantitative finance: quant. finance
quantitative marketing and economics: quant. market.. econ.
quarterly journal of austrian economics: quart. j. austrian econ.
quarterly journal of business and economics: quart. j. bus. econ.
quarterly journal of economics: quart. j. econ.
quarterly journal of indian economic studies in social science: quart. j. indian econ. stud. soc. sci.
quarterly review of agricultural economics: quart. rev. agr. econ.
quarterly review of economics and business: quart. rev. econ. bus.
quarterly review of economics and finance: quart. rev. econ. finance
quarterly review of the rural economy: quart. rev. rural economy
rand journal of economics: rand j. econ.
rassegna economica: rassegna econ.
real estate economics: real estate econ.
recherches economiques de louvain/louvain economic review: rech. econ. louvain/louvain econ. rev.
recherches economiques de louvain: rech. econ. louvain
regional science and urban economics: reg. sci. urban econ.
regional science perspectives: reg. sci. persp.
regional studies: reg. stud.
regulation: regulation
research in economics: res. econ.
research in law and economics: res. law econ.
research policy: res. pol.
resource and energy economics: resource energy econ.
resources and energy: resources energy
resources policy: resources pol.
review of accounting studies: rev. acc. stud.
review of african political economy: rev. african polit. economy
review of agricultural economics: rev. agr. econ.
review of austrian economics: rev. austrian econ.
review of black political economy: rev. black polit. economy
review of business and economic research: rev. bus. econ. res.
review of derivatives research: rev. derivatives res.
review of development economics: rev. devel. econ.
review of economic conditions in italy: rev. econ. cond. italy
review of economic design: rev. econ. design
review of economic dynamics: rev. econ. dynam.
review of economic studies: rev. econ. stud.
review of economics and statistics: rev. econ. statist.
review of financial economics: rev. finan. econ.
review of financial studies: rev. finan. stud.
review of income and wealth: rev. income wealth
review of industrial organization: rev. ind. organ.
review of international economics: rev. int. econ.
review of international political economy: rev. int. polit. economy
review of international studies: rev. int. stud.
review of marketing and agricultural economics: rev. market. agr. econ.
review of political economy: rev. polit. economy
review of public data use: rev. public data use
review of quantitative finance and accounting: rev. quant. finance acc.
review of radical political economics: rev. radical polit. econ.
review of regional studies: rev. reg. stud.
review of social economy: rev. soc. economy
review of urban and regional development studies: rev. urban reg. devel. stud.
revista brasileira de economia: revista brasileira econ.
revista de administraçao d emprêsas: revista admin. emprêsas
revista de analisis economico: revista anal. econ.
revista de econometria: revista econometria
revista de economia aplicada: revista econ. aplicada
revista de economia política/brazilian journal of political economy: revista econ. política/brazilian j. polit. economy
revista de economia política: revista econ. política
revista de economía institucional: revista econ. inst.
revista de economía y estadística, n.s.: revista econ. y estadíst.
revista de economía: revista econ.
revista de estadística: revista estadíst.
revista de estudios políticos: revista estud. polít.
revista de historia económica: revista hist. econ.
revista de historia industrial: revista hist. ind.
revista de la facultad de ciencas económicas y de administración de montevideo: revista fac. cienc. econ. admin. montevideo
revista española de economía: revista española econ.
revue canadienne des sciences de l'administration/canadian journal of administrative sciences: revue can. sci. admin./can. j. admin. sci.
revue d'economie du développement: revue econ. dével.
revue d'economie financière: revue econ. financ.
revue d'economie industrielle: revue econ. ind.
revue d'economie politique: revue econ. politique
revue d'economie regionale et urbaine: revue econ. reg. urbaine
revue d'etudes comparatives est-ouest: revue etud. compar. est-ouest
revue de l'ofce: revue l'ofce
revue de science financière: revue sci. financ.
revue economique de madagascar: revue econ. madagascar
revue economique: revue econ.
revue finance contrôle stratégie: revue finance contrôle stratégie
revue française d'economie: revue française econ.
revue française de gestion: revue française gestion
revue roumaine des sciences sociales; série sciences economiques: revue roumaine sci. soc. série sci. econ.
revue tiers monde: revue tiers monde
ricerche economiche: ricerche econ.
risec: international review of economics and business: risec: int. rev. econ. bus.
risk decision and policy: risk dec. pol.
rivista di politica economica: rivista politica econ.
rivista di statistica applicata: rivista statist. appl.
rivista di storia economica, n.s.: rivista storia econ., n.s.
rivista internazionale di scienze economiche e commerciali: rivista int. sci. econ. com.
rivista internazionale di scienze sociali: rivista int. sci. soc.
rivista italiana degli economisti: rivista italiana econ.
russian and east european finance and trade: russian e. europ. finance trade
russian economic trends: russian econ. trends
région et développement: région dével.
scandinavian economic history review: scand. econ. hist. rev.
scandinavian journal of economics: scand. j. econ.
schmollers jahrbuch für wirtschafts- und sozialwissenschaften: schmollers jahr.
schmollers jahrbuch: zeitschrift für wirtschafts- und sozialwissenschaften/journal of applied social science studies: schmollers jahr.: z. wirtsch. sozialwissen./j. appl. soc. sci. stud.
schweizerische nationalbank quartalsheft: schweiz. nationalbank quart.
schweizerische zeitschrift für volkswirtschaft und statistik/swiss journal of economics and statistics: schweiz. z. volkswirtsch. statist./swiss j. econ. statist.
schweizerische zeitschrift für volkswirtschaft und statistik: schweiz. z. volkswirtsch. statist.
science and society: sci. society
scottish journal of political economy: scot. j. polit. economy
seoul journal of economics: seoul j. econ.
singapore economic review: singapore econ. rev.
SIAM JOURNAL ON NUMERICAL ANALYSIS: SIAM. J. NUMER. ANAL.
skandinaviska banken quarterly review: skand. banken quart. rev.
sloan management review: sloan manage. rev.
small business economics: small bus. econ.
social and economic studies: soc. econ. stud.
social choice and welfare: soc. choice welfare
social research: soc. res.
social science japan journal: soc. sci. japan j.
social science quarterly: soc. sci. quart.
social security bulletin: soc. sec. bull.
south african journal of economic and management sciences, n.s.: south african j. econ. manage. sci., n.s.
south african journal of economics: south african j. econ.
southern economic journal: southern econ. j.
southern journal of agricultural economics: southern j. agr. econ.
southern quarterly: southern quart.
soviet and eastern european foreign trade: soviet e. europ. foreign trade
soviet economy: soviet economy
soviet studies: soviet stud.
spanish economic review: spanish econ. rev.
spoudai: spoudai
ssrn electronic journal: ssrn-working-paper
statistica: statistica
statistical journal: statistical j.
statistical papers: statistical pap.
statsokonomisk tidsskrift: statsokon. tidsskr.
strategic management journal: strategic. manage. j.
structural change and economic dynamics: struct. change econ. dynam.
studi economici: stud. econ.
studies in economics and finance: stud. econ. finance
studies in family planning: stud. family planning
studies in nonlinear dynamics and econometrics: stud. nonlinear dynam. econometrics
studii si cercetari economice: stud. cercet. econ.
suid-afrikaanse tydskrif vir ekonomiese en bestuurswetenskappe/south african journal of economic and management sciences, n.s.: suid-afrikaanse tydskr. ekon. bestuurswetenskappe/south african j. econ. manage. sci., n.s.
suid-afrikaanse tydskrif vir ekonomiese en bestuurswetenskappe/south african journal of economic and management sciences: suid-afrikaanse tydskr. ekon. bestuurswetenskappe/south african j. econ. manage. sci.
supreme court economic review: supreme court econ. rev.
survey of current business: surv. curr. bus.
swedish economic policy review: swedish econ. pol. rev.
swedish journal of economics: swedish j. econ.
swiss political science review: swiss polit. sci. rev.
tahqiqat-e eqtesadi (quarterly journal of economic research): tahq. eq.
taiwan economic review: taiwan econ. rev.
teaching business and economics: teaching bus. econ.
technology analysis and strategic management: tech. anal. strategic manage.
technology and culture: tech. cult.
telecommunications policy: telecommunications pol.
theory and decision: theory dec.
tijdschrift voor economie en management: tijdschr. econ. manage.
tijdschrift voor economie: tijdschr. econ.
tourism and hospitality management: tourism hospitality manage.
tourism economics: tourism econ.
trans-action: trans-action
transnational corporations: transnat. corporations
transportation journal: transp. j.
transportation research: part a: policy and practice: transp. res.: part a: pol. practice
transportation research: part b: methodological: transp. res.: part b: methodological
transportation research: part d: transport and environment: transp. res.: part d: transport environ.
transportation research: part e: logistics and transporation review: transp. res.: part e: logist. transp. rev.
transportation: transportation
travail et emploi: travail emploi
ukrainian economic review: ukrainian econ. rev.
unctad review: unctad rev.
united nations monthly chronicle: un mon. chron.
university of missouri business and government review: univ. missouri bus. govt. rev.
university of washington business review: univ. wash. bus. rev.
urban studies: urban stud.
venture capital: venture capital
vierteljahrsheftze zur wirtschaftsforschung: vierteljahrs. wirtschaftsforschung
water resources research: water resources res.
weltwirtschaftliches archiv/review of world economics: weltwirtsch. arch./rev. world econ.
weltwirtschaftliches archiv: weltwirtsch. arch.
western economic journal: western econ. j.
western journal of agricultural economics: western j. agr. econ.
wirtschaft und recht: wirtsch. recht
wirtschaftspolitische blätter: wirtschaftspolitische blätter
wissenshaftliche zeitschrift der martin luther universitat halle-wittenberg: wiss z. martin-luther univ. halle-wittenberg
working paper: working-paper
workingusa: workingusa
world bank economic review: world bank econ. rev.
world bank research observer: world bank res. observer
world development: world devel.
world economy: world economy
yale economic essays: yale econ. essays
yale journal on regulation: yale j. regul.
yale law journal: yale law j.
yapi kredi economic review: yapi kredi econ. rev.
yorkshire bull. econ. soc. res.: yorkshire bull. econ. soc. res.
zagreb international review of economics and business: zagreb int. rev. econ. bus.
zbornik radova ekonomskog fakulteta rijeka: zbornik radova ekon. fakul. rijeka
zbornik radova ekonomskog fakulteta u. rijeci/proceedings of rijeka school of economics: journal of economics and business: zbornik radova ekon. fakul. u. rijeci/proceed. rijeka sch. econ.: j. econ. bus.
zeitschrift für allgemaine und textile marktwirts schaft: z. allg. textile marktwirtsch.
zeitschrift für betriebswirtschaft: z. betriebswirtschaft
zeitschrift für die gesamte staatswissenschaft (jite): z. ges. staatswissen. (jite)
zeitschrift für nationalökonomie: z. nationalökon.
zeitschrift für wirtschafts- und sozialwissenschaften: z. wirtsch. sozialwissen.
zeitschrift für wirtschaftspolitik: z. wirtschaftspolitik
